NO ./textures/north.xpm
SO ./textures/south.xpm
WE ./textures/west.xpm
EA ./textures/east.xpm
F 100,150,200
C 255,200,100

111111
100001
10000111
10000N01
11111111
